NO assets/armenistan.xpm
SO assets/pakistan.xpm
WE assets/turkmenistan.xpm
EA assets/uzbekistan.xpm
F 200, 100, 50
C 250, 0, 100

111111111111111
100000000000001
100000N00000001
100000000000001
1000000000000011 111111
111111111111111111111
